11111 11111 11111 11111 11111
10000 00000 00000 00000 00001
10000 00000 00000 00000 00001
10000 00000 00000 00000 00001
10000 00000 00000 00000 00001

10000 00000 00000 00000 00001
12000 00000 00000 00020 00001
02000 00000 40000 00020 00000
02000 00000 00000 00020 00000
10000 00000 00000 00020 00001

12000 00000 00000 00000 00001
12000 20200 00000 00000 00001
02000 00000 30000 00000 00000
02000 00000 00000 00000 00000
12000 00000 00000 00000 00001

10000 00000 00000 00220 00001
10000 00000 00000 00200 00001
00000 00000 30000 00200 00000
00000 00000 00000 00000 00000
10000 00000 00000 00000 00001

10000 00000 00000 00020 00000
10000 00005 00000 00020 00000
00000 00000 00000 00000 00001
00000 00000 00000 00000 00001
11111 11111 11111 11111 11111