11111 11111 11111 11111 11111
12211 10000 00000 00000 00001
10000 10000 00000 00020 00001
10000 10000 22222 00020 10001
10000 10000 00000 00020 10001

00000 00000 00000 00020 11000
22222 00000 04000 00320 11000
10000 00000 00000 00020 11001
10000 00000 00000 00020 00001
00000 00000 01111 00000 00000

10000 03000 00000 00020 00001
10000 00000 00000 00020 00001
11111 00000 00000 00000 00001
00000 11111 11111 00000 00000
00002 22200 00000 00000 00000

10002 10000 00000 00000 00001
10002 10300 11111 00500 00001
10002 10000 00001 00000 00001
00002 10000 00001 00000 00000
22222 10000 00001 00000 00000

12222 10000 00000 22222 00001
12222 10000 00000 22222 00001
12222 00000 00000 22222 00001
12222 00000 00000 22222 00001
11111 11111 11111 11111 11111